________
___   F_
_     F_
_    ___
_SSSS___
________